08,04,04,04,04,04,04,04,04,04,04,04,09
07,13,13,13,13,13,12,13,13,13,13,13,01
07,13,13,13,13,13,13,13,13,13,13,13,01
07,13,13,13,13,04,04,04,13,13,13,13,01
07,13,07,14,13,13,12,13,13,15,01,13,01
07,13,13,13,13,13,13,13,13,13,13,13,01
11,02,02,02,02,02,02,02,02,02,02,02,10

1,1,1,1,1,1,1,1,1,1,1,1,1
1,0,0,0,0,0,0,0,0,0,0,0,1
1,0,0,0,0,0,0,0,0,0,0,0,1
1,0,0,0,0,0,0,0,0,0,0,0,1
1,0,0,0,0,0,0,0,0,0,0,0,1
1,0,0,0,0,0,0,0,0,0,0,0,1
1,1,1,1,1,1,1,1,1,1,1,1,1