08,04,04,04,04,04,04,04,04,04,04,04,09
07,13,13,13,13,13,12,13,13,13,13,13,01
07,13,13,13,13,13,13,13,13,13,13,13,01
07,13,13,13,13,04,04,04,13,13,13,13,01
07,13,07,14,13,13,12,13,13,15,01,13,01
07,13,13,13,13,13,13,13,13,13,13,13,01
11,02,02,02,02,02,02,02,02,02,02,02,10

00,18,18,18,18,18,18,18,18,18,18,18,00
16,00,00,00,00,00,23,00,00,00,00,00,19
16,00,00,00,00,00,00,00,00,00,00,00,19
16,00,00,00,00,18,18,18,00,00,00,00,19
16,00,16,21,00,00,23,00,00,22,19,00,19
16,00,00,00,00,00,00,00,00,00,00,00,19
00,20,20,20,20,20,20,20,20,20,20,20,00

0,0,0,0,0,0,0,0,0,0,0,0,0
0,1,1,1,1,1,0,1,1,1,1,2,0
0,2,1,1,1,1,1,1,1,1,1,1,0
0,1,1,1,1,1,1,1,1,1,1,1,0
0,1,1,0,1,1,0,1,1,0,1,1,0
0,1,1,1,1,1,1,1,1,1,1,2,0
0,0,0,0,0,0,0,0,0,0,0,0,0
