1,1,1,1,1,1,1,1,1,1
2,9,9,9,9,9,9,9,9,3
2,9,9,9,9,9,9,9,9,3
2,9,9,9,9,9,9,9,9,3
2,9,9,9,9,9,9,9,9,3
2,9,9,9,9,9,9,9,9,3
2,9,9,9,9,9,9,9,9,3
2,9,9,9,9,9,9,9,9,3
2,9,9,9,9,9,9,9,9,3
1,0,0,0,0,0,0,0,0,1