01,01,01,01,01,01,01,01,01,01
02,09,09,09,09,09,09,09,09,03
02,09,09,09,09,09,09,09,09,03
02,09,09,09,09,09,09,09,09,03
02,09,09,09,09,09,09,09,09,03
02,09,09,09,09,09,09,09,09,03
02,09,09,09,09,09,09,09,09,03
02,09,09,09,09,09,09,09,09,03
02,09,09,09,09,09,09,09,09,03
01,00,00,00,00,00,00,00,00,01